0000000000000000000
0111111110111111110
0100100010100010010
0111111111111111110
0100101000001010010
0111101110111011110
0000100020200010000
2220102222222010222
0000102002002010000
2222122022202212222
0000102000002010000
2220102222222010222
0000102000002010000
0111111110111111110
0100100010100010010
0110111111111110110
0010101000001010100
0111101110111011110
0100000010100000010
0111111111111111110
0000000000000000000